0001111111110000
0000000110001010
0001110110101010
0111110000101010
0100000000001010
0101111111111010
0100000000000010
0111111111111110
0010000001100110
1000111100000000
1011000001111001
1000010000000004