0001101111111111
1101000100001000
1101010101100011
1101010101101111
1101010101101111
1101010101101000
1101010101101011
0001010100100001
1101010111101101
1101010111101101
1100010000001101
1111111111111104