0111111111111101
0111111000000001
0001111011011101
1101101000011101
1101111011011101
1101111011000111
1100000011011101
1101111101000001
0101111111111101
0100000000010001
0111111111010111
0000000000010004