0111111000000111
0000111011110101
0000111011110101
0000100011110111
0011111010000111
1011111010111111
1000001010000001
1111100010111101
1100001010100001
1001111110000111
1000001111110004