0000000011110111
1111111011110111
1110111011000000
1000111011011110
1010000011010010
1011111011011010
1011111011011010
1011001011000010
1011111011111110
1111000001111111
0011111100000004